NomApplication	NAM	<unknown>
:	PUN	:
Ebook	NAM	<unknown>
et	KON	et
PDF	NAM	<unknown>
Reader	NAM	<unknown>
IdApplication	NAM	<unknown>
:	PUN	:
books	NOM	<unknown>
.	SENT	.
ebook	NOM	<unknown>
.	SENT	.
pdf	NOM	<unknown>
.	SENT	.
reader	NOM	reader
CategorieApplication	NAM	<unknown>
:	PUN	:
Livres	NOM	livre
et	KON	et
références	NOM	référence
NoteApplication:4,3	ABR	<unknown>
NombreVotants:43	ABR	<unknown>
379	NUM	@card@
TitreCommentaire	NOM	<unknown>
:	PUN	:
Pratique	NOM	pratique
Commentaire	NAM	<unknown>
:	PUN	:
On	PRO:PER	on
retrouve	VER:pres	retrouver
tous	PRO:IND	tout
nos	DET:POS	notre
documents	NOM	document
dans	PRP	dans
une	DET:ART	un
seule	ADJ	seul
appli	NOM	<unknown>
.	SENT	.
C'	PRO:DEM	ce
est	VER:pres	être
très	ADV	très
pratique	ADJ	pratique
.	SENT	.
DateCommentaire:4	ABR	<unknown>
septembre	NOM	septembre
2014	NUM	@card@
NoteCommentaire:5	ABR	<unknown>
