NomApplication	NOM	<unknown>
:	PUN	:
M√©t√©o	ADJ	m√©t√©o
pour	PRP	pour
le	DET:ART	le
Monde	NAM	Monde
IdApplication	NAM	<unknown>
:	PUN	:
com	NOM	<unknown>
.	SENT	.
idmobile	NOM	<unknown>
.	SENT	.
worldmeteo	NOM	<unknown>
CategorieApplication	NAM	<unknown>
:	PUN	:
M√©t√©o	NOM	m√©t√©o
NoteApplication:4,3	NAM	<unknown>
NombreVotants:4	ABR	<unknown>
283	NUM	@card@
TitreCommentaire	NOM	<unknown>
:	PUN	:
Parfait	ADJ	parfait
Commentaire	NAM	<unknown>
:	PUN	:
Les	DET:ART	le
donn√©es	NOM	donn√©e
sont	VER:pres	√™tre
vraies	ADJ	vrai
,	PUN	,
justes	ADJ	juste
,	PUN	,
r√©elles	ADJ	r√©el
.	SENT	.
Tr√®s	ADV	tr√®s
pratique	ADJ	pratique
pour	PRP	pour
le	DET:ART	le
quotidien	ADJ	quotidien
üòä	NOM	<unknown>
DateCommentaire:21	ABR	<unknown>
octobre	NOM	octobre
2014	NUM	@card@
NoteCommentaire:5	ABR	<unknown>
