NomApplication	NAM	<unknown>
:	PUN	:
WhatsApp	NAM	<unknown>
Wallpaper	NAM	<unknown>
IdApplication	NAM	<unknown>
:	PUN	:
com	NOM	<unknown>
.	SENT	.
whatsapp	NOM	<unknown>
.	SENT	.
wallpaper	NOM	<unknown>
CategorieApplication	NAM	<unknown>
:	PUN	:
Personnalisation	NOM	personnalisation
NoteApplication:3,9	NAM	<unknown>
NombreVotants:1	ABR	<unknown>
302	NUM	@card@
706	NUM	@card@
TitreCommentaire	NOM	<unknown>
:	PUN	:
Sa	DET:POS	son
p	NOM	<unknown>
alé	VER:futu	<unknown>
Commentaire	ADJ	<unknown>
:	PUN	:
Cool	ADJ	cool
cool	NOM	cool
DateCommentaire:8	ABR	<unknown>
août	NOM	août
2013	NUM	@card@
NoteCommentaire:3	ABR	<unknown>
