NomApplication	NAM	<unknown>
:	PUN	:
Call	NAM	<unknown>
of	VER:simp	<unknown>
Duty	NAM	<unknown>
:	PUN	:
Advanced	NAM	<unknown>
Warfare	NAM	<unknown>
IdApplication	NAM	<unknown>
:	PUN	:
com	NOM	<unknown>
.	SENT	.
activision	NOM	<unknown>
.	SENT	.
codm2	NOM	<unknown>
CategorieApplication	NAM	<unknown>
:	PUN	:
Divertissement	NOM	divertissement
NoteApplication:3,9	NAM	<unknown>
NombreVotants:17	ABR	<unknown>
284	NUM	@card@
TitreCommentaire	NAM	<unknown>
:	PUN	:
GT	NAM	<unknown>
:	PUN	:
alexrom51	NOM	<unknown>
Commentaire	NAM	<unknown>
:	PUN	:
Faucon	NOM	faucon
Royal	NAM	Royal
recrute	VER:pres	recruter
joueur	NOM	joueur
Xbox	NAM	<unknown>
360	NUM	@card@
venez	VER:pres	venir
sinon	KON	sinon
bonne	ADJ	bon
applis	NOM	<unknown>
DateCommentaire:22	ABR	<unknown>
novembre	NOM	novembre
2014	NUM	@card@
NoteCommentaire:5	ABR	<unknown>
