NomApplication	NOM	<unknown>
:	PUN	:
Smart	ADJ	smart
Voice	NAM	<unknown>
Recorder	NAM	<unknown>
IdApplication	NAM	<unknown>
:	PUN	:
com	NOM	<unknown>
.	SENT	.
andrwq	NOM	<unknown>
.	SENT	.
recorder	NOM	recorder
CategorieApplication	NAM	<unknown>
:	PUN	:
Musique	NOM	musique
et	KON	et
audio	NOM	<unknown>
NoteApplication:4,4	ABR	<unknown>
NombreVotants:223	ABR	<unknown>
318	NUM	@card@
TitreCommentaire	NOM	<unknown>
:	PUN	:
Commentaire	NOM	commentaire
:	PUN	:
Pour	PRP	pour
passer	VER:infi	passer
une	DET:ART	un
entrevue	NOM	entrevue
cette	PRO:DEM	ce
application	NOM	application
est	VER:pres	être
géniale	ADJ	génial
!	SENT	!
J'	PRO:PER	je
étais	VER:impf	être
dans	PRP	dans
un	DET:ART	un
café	NOM	café
et	KON	et
malgré	PRP	malgré
tous	PRO:IND	tout
les	DET:ART	le
bruits	NOM	bruit
ambiants	ADJ	ambiant
la	DET:ART	le
qualité	NOM	qualité
de	PRP	de
l'	DET:ART	le
enregistrement	NOM	enregistrement
est	VER:pres	être
très	ADV	très
bien	ADV	bien
!	SENT	!
DateCommentaire:17	ABR	<unknown>
novembre	NOM	novembre
2014	NUM	@card@
NoteCommentaire:5	ABR	<unknown>
