NomApplication	NAM	<unknown>
:	PUN	:
Talking	NAM	<unknown>
Tom	NAM	<unknown>
Cat	NAM	<unknown>
2	NUM	@card@
Free	NOM	<unknown>
IdApplication	NOM	<unknown>
:	PUN	:
com	NOM	<unknown>
.	SENT	.
outfit7	NOM	<unknown>
.	SENT	.
talkingtom2free	NOM	<unknown>
CategorieApplication	NAM	<unknown>
:	PUN	:
Divertissement	NOM	divertissement
NoteApplication:4,4	NAM	<unknown>
NombreVotants:1	ABR	<unknown>
886	NUM	@card@
406	NUM	@card@
TitreCommentaire	NOM	<unknown>
:	PUN	:
Trop	ADV	trop
cool	ADJ	cool
Commentaire	NAM	<unknown>
:	PUN	:
c	VER:simp	<unknown>
cool	ADJ	cool
talking	NOM	<unknown>
Tom	NAM	<unknown>
2	NUM	@card@
j'	PRO:PER	je
aime	VER:pres	aimer
bien	ADV	bien
moi	PRO:PER	moi
lui	PRO:PER	lui
donner	VER:infi	donner
des	PRP:det	du
claques	NOM	claque
et	KON	et
il	PRO:PER	il
tombe	VER:pres	tomber
parfois	ADV	parfois
Lol	NAM	<unknown>
Et	NAM	<unknown>
je	PRO:PER	je
suis	VER:pres	suivre|être
d'accord	ADV	d'accord
avec	PRP	avec
d'	PRP	de
autre	ADJ	autre
commentaire	NOM	commentaire
ce	PRO:DEM	ce
serai	VER:futu	être
bien	ADV	bien
s'	PRO:PER	se
il	PRO:PER	il
souriait	VER:impf	sourire
parfois	ADV	parfois
DateCommentaire:3	ADJ	<unknown>
novembre	NOM	novembre
2014	NUM	@card@
NoteCommentaire:4	ABR	<unknown>
