NomApplication	NAM	<unknown>
:	PUN	:
Sound	NAM	<unknown>
Search	NAM	<unknown>
for	NOM	for
Google	NAM	<unknown>
Play	NAM	<unknown>
IdApplication	NAM	<unknown>
:	PUN	:
com	NOM	<unknown>
.	SENT	.
google	NOM	<unknown>
.	SENT	.
android	NOM	<unknown>
.	SENT	.
ears	NOM	<unknown>
CategorieApplication	NAM	<unknown>
:	PUN	:
Musique	NOM	musique
et	KON	et
audio	NOM	<unknown>
NoteApplication:4,1	ABR	<unknown>
NombreVotants:57	ABR	<unknown>
432	NUM	@card@
TitreCommentaire	NOM	<unknown>
:	PUN	:
Peut	VER:pres	pouvoir
mieux	ADV	mieux
faire	VER:infi	faire
Commentaire	NAM	<unknown>
:	PUN	:
Parfois	ADV	parfois
moins	ADV	moins
bon	ADJ	bon
que	KON	que
ses	DET:POS	son
concurrents	NOM	concurrent
mais	KON	mais
il	PRO:PER	il
manque	VER:pres	manquer
surtout	ADV	surtout
un	DET:ART	un
lien	NOM	lien
direct	ADJ	direct
pour	PRP	pour
ajouter	VER:infi	ajouter
aux	PRP:det	au
playlist	NOM	<unknown>
des	PRP:det	du
utilisateurs	ADJ	utilisateur
"	PUN:cit	"
all	NOM	<unknown>
access	ADJ	<unknown>
"	PUN:cit	"
de	PRP	de
Google	NAM	<unknown>
music	NOM	<unknown>
...	PUN	...
DateCommentaire:3	ABR	<unknown>
novembre	NOM	novembre
2014	NUM	@card@
NoteCommentaire:3	ABR	<unknown>
