NomApplication	NAM	<unknown>
:	PUN	:
SNCF	ABR	SNCF
TER	NAM	<unknown>
Mobile	NAM	<unknown>
IdApplication	NAM	<unknown>
:	PUN	:
com	NOM	<unknown>
.	SENT	.
ter	ADV	ter
.	SENT	.
androidapp	NOM	<unknown>
CategorieApplication	NAM	<unknown>
:	PUN	:
Transports	NOM	transport
NoteApplication:3,7	NAM	<unknown>
NombreVotants:2	ABR	<unknown>
826	NUM	@card@
TitreCommentaire	NOM	<unknown>
:	PUN	:
Pas	ADV	pas
a	VER:pres	avoir
jour	NOM	jour
Commentaire	ADJ	<unknown>
:	PUN	:
Annonce	NOM	annonce
des	PRP:det	du
horaire	ADJ	horaire
alors	ADV	alors
qu'	KON	que
en	PRO:PER	en
gare	VER:subp	garer
c'	PRO:DEM	ce
est	VER:pres	être
pas	ADV	pas
du	PRP:det	du
tout	NOM	tout
pareil	ADJ	pareil
.	SENT	.
20mn	NOM	<unknown>
d'	PRP	de
attente	NOM	attente
par	PRP	par
rapport	NOM	rapport
a	VER:pres	avoir
l'	DET:ART	le
horaire	NOM	horaire
annoncé	VER:pper	annoncer
par	PRP	par
l'	DET:ART	le
appli	NOM	<unknown>
DateCommentaire:28	ABR	<unknown>
juillet	NOM	juillet
2014	NUM	@card@
NoteCommentaire:1	ABR	<unknown>
