NomApplication	NAM	<unknown>
:	PUN	:
Facebook	NAM	<unknown>
IdApplication	NAM	<unknown>
:	PUN	:
com	NOM	<unknown>
.	SENT	.
facebook	NOM	<unknown>
.	SENT	.
katana	NOM	katana
CategorieApplication	NAM	<unknown>
:	PUN	:
Social	ADJ	social
NoteApplication:4,0	NAM	<unknown>
NombreVotants:23	ABR	<unknown>
307	NUM	@card@
464	NUM	@card@
TitreCommentaire	NOM	<unknown>
:	PUN	:
De	PRP	de
plus	ADV	plus
en	PRP	en
plus	ADV	plus
nul	ADJ	nul
Commentaire	NAM	<unknown>
:	PUN	:
Je	PRO:PER	je
ne	ADV	ne
peux	VER:pres	pouvoir
même	ADV	même
plus	ADV	plus
installer	VER:infi	installer
Facebook	NOM	<unknown>
depuis	PRP	depuis
une	DET:ART	un
récente	ADJ	récent
mise	NOM	mise
à	PRP	à
jour	NOM	jour
sur	PRP	sur
mon	DET:POS	mon
Xperia	NAM	<unknown>
E1	ABR	<unknown>
DateCommentaire:23	ABR	<unknown>
novembre	NOM	novembre
2014	NUM	@card@
NoteCommentaire:1	ABR	<unknown>
