NomApplication	NAM	<unknown>
:	PUN	:
Sky	NAM	<unknown>
Map	NAM	<unknown>
IdApplication	NAM	<unknown>
:	PUN	:
com	NOM	<unknown>
.	SENT	.
google	NOM	<unknown>
.	SENT	.
android	NOM	<unknown>
.	SENT	.
stardroid	NOM	<unknown>
CategorieApplication	NAM	<unknown>
:	PUN	:
Livres	NOM	livre
et	KON	et
références	NOM	référence
NoteApplication:4,5	ABR	<unknown>
NombreVotants:427	ABR	<unknown>
255	NUM	@card@
TitreCommentaire	NOM	<unknown>
:	PUN	:
attention	NOM	attention
position	NOM	position
Commentaire	ADJ	<unknown>
:	PUN	:
Pour	KON	pour
vraiment	ADV	vraiment
indiquer	VER:infi	indiquer
la	DET:ART	le
position	NOM	position
correspond	VER:pres	correspondre
correcte	ADJ	correct
l'	DET:ART	le
appareil	NOM	appareil
doit	VER:pres	devoir
être	VER:infi	être
place	NOM	place
face	NOM	face
a	VER:pres	avoir
vous	PRO:PER	vous
et	KON	et
perpendiculaire	ADJ	perpendiculaire
au	PRP:det	au
sol	NOM	sol
DateCommentaire:8	ABR	<unknown>
septembre	NOM	septembre
2012	NUM	@card@
NoteCommentaire:4	ABR	<unknown>
