NomApplication	NAM	<unknown>
:	PUN	:
My	NAM	<unknown>
Auchan	NAM	<unknown>
IdApplication	NAM	<unknown>
:	PUN	:
com	NOM	<unknown>
.	SENT	.
auchan	NOM	<unknown>
.	SENT	.
android	NOM	<unknown>
CategorieApplication	NAM	<unknown>
:	PUN	:
Shopping	NOM	shopping
NoteApplication:3,4	NAM	<unknown>
NombreVotants:2	ABR	<unknown>
034	NUM	@card@
TitreCommentaire	NOM	<unknown>
:	PUN	:
Sympa	ADJ	sympa
mais	KON	mais
...	PUN	...
Commentaire	NAM	<unknown>
:	PUN	:
L'	DET:ART	le
application	NOM	application
en	PRP	en
elle	PRO:PER	elle
meme	NOM	<unknown>
est	VER:pres	être
plus	ADV	plus
sympa	ADJ	sympa
que	KON	que
l'	DET:ART	le
ancienne	ADJ	ancien
et	KON	et
le	DET:ART	le
correctif	NOM	correctif
pour	PRP	pour
les	DET:ART	le
whaouu	NOM	<unknown>
est	VER:pres	être
passer	VER:infi	passer
5/5	NUM	@card@
:	PUN	:
D	ABR	<unknown>
DateCommentaire:14	ABR	<unknown>
octobre	NOM	octobre
2014	NUM	@card@
NoteCommentaire:5	ABR	<unknown>
