NomApplication	NAM	<unknown>
:	PUN	:
InstaFace	NAM	<unknown>
:	PUN	:
face	NOM	face
eyes	NOM	<unknown>
morph	ADJ	<unknown>
IdApplication	NOM	<unknown>
:	PUN	:
com	NOM	<unknown>
.	SENT	.
baiwang	NOM	<unknown>
.	SENT	.
instaface	NOM	<unknown>
CategorieApplication	NAM	<unknown>
:	PUN	:
Photographie	NOM	photographie
NoteApplication:4,0	NAM	<unknown>
NombreVotants:146	ABR	<unknown>
527	NUM	@card@
TitreCommentaire	NOM	<unknown>
:	PUN	:
Commentaire	NOM	commentaire
:	PUN	:
Très	ADV	très
bien	ADV	bien
fait	VER:pper	faire
!	SENT	!
DateCommentaire:17	ABR	<unknown>
octobre	NOM	octobre
2014	NUM	@card@
NoteCommentaire:5	ABR	<unknown>
