NomApplication	NAM	<unknown>
:	PUN	:
Audible	NOM	audible
pour	PRP	pour
Android	NAM	<unknown>
IdApplication	NAM	<unknown>
:	PUN	:
com	NOM	<unknown>
.	SENT	.
audible	NOM	audible
.	SENT	.
application	NOM	application
CategorieApplication	NAM	<unknown>
:	PUN	:
Livres	NOM	livre
et	KON	et
références	NOM	référence
NoteApplication:4,2	ABR	<unknown>
NombreVotants:124	ABR	<unknown>
998	NUM	@card@
TitreCommentaire	NOM	<unknown>
:	PUN	:
Perte	NOM	perte
de	PRP	de
temps	NOM	temps
Commentaire	ADJ	<unknown>
:	PUN	:
Comme	ADV	comme
bon	ADJ	bon
nombres	NOM	nombre
d'	PRP	de
app	NOM	<unknown>
,	PUN	,
rien	NOM	rien
pour	PRP	pour
facilité	NOM	facilité
la	DET:ART	le
recherche	NOM	recherche
française	ADJ	français
.	SENT	.
Pourquoi	ADV	pourquoi
présenter	VER:infi	présenter
des	PRP:det	du
livres	NOM	livre
en	PRP	en
anglais	ADJ	anglais
quand	KON	quand
on	PRO:PER	on
installé	VER:pper	installer
l'	DET:ART	le
App	NOM	<unknown>
en	PRP	en
français	NOM	français
DateCommentaire:9	ABR	<unknown>
septembre	NOM	septembre
2014	NUM	@card@
NoteCommentaire:1	ABR	<unknown>
