NomApplication	NAM	<unknown>
:	PUN	:
Entraînements	NOM	entraînement
Quotidiens	NAM	<unknown>
FREE	NAM	<unknown>
IdApplication	NAM	<unknown>
:	PUN	:
com	NOM	<unknown>
.	SENT	.
tinymission	NOM	<unknown>
.	SENT	.
dailyworkoutsfree	NOM	<unknown>
CategorieApplication	NAM	<unknown>
:	PUN	:
Santé	NOM	santé
et	KON	et
remise	VER:pper	remettre
en	PRP	en
forme	NOM	forme
NoteApplication:4,1	ABR	<unknown>
NombreVotants:39	ABR	<unknown>
823	NUM	@card@
TitreCommentaire	NOM	<unknown>
:	PUN	:
Génial	ADJ	génial
Commentaire	NAM	<unknown>
:	PUN	:
Enfin	ADV	enfin
une	DET:ART	un
appli	NOM	<unknown>
avec	PRP	avec
des	PRP:det	du
exercices	NOM	exercice
correct	ADJ	correct
et	KON	et
qui	PRO:REL	qui
motive	VER:pres	motiver
!	SENT	!
DateCommentaire:17	ABR	<unknown>
juillet	NOM	juillet
2014	NUM	@card@
NoteCommentaire:5	ABR	<unknown>
