NomApplication	NAM	<unknown>
:	PUN	:
Radars	NOM	radar
France	NAM	France
IdApplication	NAM	<unknown>
:	PUN	:
com	NOM	<unknown>
.	SENT	.
sygic	NOM	<unknown>
.	SENT	.
speedcamapp	NOM	<unknown>
CategorieApplication	NAM	<unknown>
:	PUN	:
Transports	NOM	transport
NoteApplication:4,0	NAM	<unknown>
NombreVotants:7	ABR	<unknown>
099	NUM	@card@
TitreCommentaire	NOM	<unknown>
:	PUN	:
Commentaire	NOM	commentaire
:	PUN	:
Très	ADV	très
motivant	ADJ	motivant
pour	PRP	pour
les	DET:ART	le
randonnées	NOM	randonnée
vélo	NOM	vélo
DateCommentaire:10	ABR	<unknown>
septembre	NOM	septembre
2014	NUM	@card@
NoteCommentaire:4	ABR	<unknown>
