NomApplication	NAM	<unknown>
:	PUN	:
Twitter	NAM	<unknown>
IdApplication	NAM	<unknown>
:	PUN	:
com	NOM	<unknown>
.	SENT	.
twitter	NOM	<unknown>
.	SENT	.
android	NOM	<unknown>
CategorieApplication	NAM	<unknown>
:	PUN	:
Social	ADJ	social
NoteApplication:4,1	NAM	<unknown>
NombreVotants:4	ABR	<unknown>
103	NUM	@card@
470	NUM	@card@
TitreCommentaire	NOM	<unknown>
:	PUN	:
Ouais	INT	ouais
okk	NOM	<unknown>
et	KON	et
?	SENT	?
Rien	NOM	rien
de	PRP	de
nouveau	ADJ	nouveau
Commentaire	NAM	<unknown>
:	PUN	:
Toujours	ADV	toujours
des	PRP:det	du
mises	NOM	mise
a	VER:pres	avoir
jour	NOM	jour
mais	KON	mais
jamais	ADV	jamais
de	PRP	de
changement	NOM	changement
alors	ADV	alors
que	KON	que
chez	PRP	chez
iOs	NOM	<unknown>
l'	DET:ART	le
interface	NOM	interface
a	VER:pres	avoir
complètement	ADV	complètement
changée	VER:pper	changer
DateCommentaire:18	ADJ	<unknown>
novembre	NOM	novembre
2014	NUM	@card@
NoteCommentaire:1	ABR	<unknown>
