NomApplication	NAM	<unknown>
:	PUN	:
vente-privee	NOM	<unknown>
IdApplication	NAM	<unknown>
:	PUN	:
com	NOM	<unknown>
.	SENT	.
venteprivee	NOM	<unknown>
CategorieApplication	NAM	<unknown>
:	PUN	:
Shopping	NOM	shopping
NoteApplication:3,9	NAM	<unknown>
NombreVotants:5	ABR	<unknown>
926	NUM	@card@
TitreCommentaire	NOM	<unknown>
:	PUN	:
Commentaire	NOM	commentaire
:	PUN	:
Bien	ADV	bien
des	PRP:det	du
efforts	NOM	effort
ont	VER:pres	avoir
été	VER:pper	être
fait	VER:pper	faire
sur	PRP	sur
cette	PRO:DEM	ce
application	NOM	application
depuis	PRP	depuis
ses	DET:POS	son
débuts	NOM	début
catastrophique	ADJ	catastrophique
...	PUN	...
continuez	VER:pres	continuer
dans	PRP	dans
cette	PRO:DEM	ce
lancée	NOM	lancée
!	SENT	!
DateCommentaire:22	ABR	<unknown>
novembre	NOM	novembre
2014	NUM	@card@
NoteCommentaire:4	ABR	<unknown>
