NomApplication	NAM	<unknown>
:	PUN	:
LaBox	NAM	<unknown>
TV	ABR	TV
IdApplication	NOM	<unknown>
:	PUN	:
com	NOM	<unknown>
.	SENT	.
numericable	ADJ	<unknown>
.	SENT	.
lbew	NOM	<unknown>
CategorieApplication	NAM	<unknown>
:	PUN	:
Divertissement	NOM	divertissement
NoteApplication:3,4	NAM	<unknown>
NombreVotants:1	ABR	<unknown>
871	NUM	@card@
TitreCommentaire	NOM	<unknown>
:	PUN	:
Une	DET:ART	un
catastrophe	NOM	catastrophe
Commentaire	ADJ	<unknown>
:	PUN	:
Une	DET:ART	un
honte	NOM	honte
que	PRO:REL	que
cette	PRO:DEM	ce
application	NOM	application
.	SENT	.
Ne	ADV	ne
reconnait	VER:pres	reconnaître
pas	ADV	pas
le	DET:ART	le
réseau	NOM	réseau
de	PRP	de
sa	DET:POS	son
propre	ADJ	propre
box	NOM	box
,	PUN	,
erreur	NOM	erreur
en	PRP	en
tous	PRO:IND	tout
genre	NOM	genre
...	PUN	...
.	SENT	.
.	SENT	.
Comment	ADV	comment
peut	VER:pres	pouvoir
on	PRO:PER	on
oser	VER:infi	oser
mettre	VER:infi	mettre
en	PRP	en
ligne	NOM	ligne
ça	PRO:DEM	cela
?	SENT	?
?	SENT	?
?	SENT	?
?	SENT	?
?	SENT	?
DateCommentaire:24	ABR	<unknown>
octobre	NOM	octobre
2014	NUM	@card@
NoteCommentaire:1	ABR	<unknown>
