NomApplication	NAM	<unknown>
:	PUN	:
Flash	NOM	flash
on	PRO:PER	on
WebView	NAM	<unknown>
IdApplication	NAM	<unknown>
:	PUN	:
com	NOM	<unknown>
.	SENT	.
nambudenki	ADJ	<unknown>
.	SENT	.
android	NOM	<unknown>
.	SENT	.
fow	NOM	<unknown>
CategorieApplication	NAM	<unknown>
:	PUN	:
Livres	NOM	livre
et	KON	et
références	NOM	référence
NoteApplication:3,5	ABR	<unknown>
NombreVotants:5	ABR	<unknown>
726	NUM	@card@
TitreCommentaire	NOM	<unknown>
:	PUN	:
Marche	NOM	marche
pas	ADV	pas
...	PUN	...
Commentaire	NAM	<unknown>
:	PUN	:
Ne	ADV	ne
fonctionne	VER:pres	fonctionner
pas	ADV	pas
...	PUN	...
DateCommentaire:10	ABR	<unknown>
novembre	NOM	novembre
2014	NUM	@card@
NoteCommentaire:1	ABR	<unknown>
