NomApplication:4shared	ADJ	<unknown>
IdApplication	NOM	<unknown>
:	PUN	:
com	NOM	<unknown>
.	SENT	.
forshared	NOM	<unknown>
CategorieApplication	NAM	<unknown>
:	PUN	:
Divertissement	NOM	divertissement
NoteApplication:4,3	NAM	<unknown>
NombreVotants:1	ABR	<unknown>
776	NUM	@card@
504	NUM	@card@
TitreCommentaire	NAM	<unknown>
:	PUN	:
Genial	NAM	<unknown>
Commentaire	NAM	<unknown>
:	PUN	:
cette	PRO:DEM	ce
application	NOM	application
est	VER:pres	être
vraiment	ADV	vraiment
génial	ADJ	génial
vous	PRO:PER	vous
pouvez	VER:pres	pouvoir
télécharger	VER:infi	<unknown>
tout	PRO:IND	tout
photos	NOM	photo
vidéos	NOM	vidéo
application	NOM	application
et	KON	et
music	NOM	<unknown>
gratuitement	ADV	gratuitement
!	SENT	!
!	SENT	!
!	SENT	!
DateCommentaire:11	ABR	<unknown>
novembre	NOM	novembre
2014	NUM	@card@
NoteCommentaire:5	ABR	<unknown>
