NomApplication	NAM	<unknown>
:	PUN	:
Groupon	NAM	<unknown>
IdApplication	NAM	<unknown>
:	PUN	:
com	NOM	<unknown>
.	SENT	.
groupon	NOM	<unknown>
CategorieApplication	NAM	<unknown>
:	PUN	:
Shopping	NOM	shopping
NoteApplication:4,5	NAM	<unknown>
NombreVotants:636	ABR	<unknown>
479	NUM	@card@
TitreCommentaire	NOM	<unknown>
:	PUN	:
Commentaire	NOM	commentaire
:	PUN	:
J'	PRO:PER	je
adore	VER:pres	adorer
Groupon	NOM	<unknown>
depuis	PRP	depuis
que	PRO:REL	que
je	PRO:PER	je
connais	VER:pres	conna√Ætre
votre	DET:POS	votre
site	NOM	site
je	PRO:PER	je
peux	VER:pres	pouvoir
me	PRO:PER	me
permettre	VER:infi	permettre
plein	ADJ	plein
de	PRP	de
loisir	NOM	loisir
pour	PRP	pour
moi	PRO:PER	moi
et	KON	et
mes	DET:POS	mon
enfts	NOM	<unknown>
vs	NOM	<unknown>
etes	VER:subp	<unknown>
extra	NOM	extra
DateCommentaire:17	ABR	<unknown>
novembre	NOM	novembre
2014	NUM	@card@
NoteCommentaire:5	ABR	<unknown>
