NomApplication	NAM	<unknown>
:	PUN	:
iCoyote	NOM	<unknown>
Avertisseur	NAM	<unknown>
de	PRP	de
dangers	NOM	danger
IdApplication	NOM	<unknown>
:	PUN	:
com	NOM	<unknown>
.	SENT	.
coyotesystems	NOM	<unknown>
.	SENT	.
android	NOM	<unknown>
CategorieApplication	NAM	<unknown>
:	PUN	:
Transports	NOM	transport
NoteApplication:4,0	NAM	<unknown>
NombreVotants:12	ABR	<unknown>
827	NUM	@card@
TitreCommentaire	NOM	<unknown>
:	PUN	:
Très	ADV	très
bien	ADV	bien
Commentaire	ADJ	<unknown>
:	PUN	:
Application	NOM	application
très	ADV	très
bien	ADV	bien
rentabilisé	VER:pper	rentabiliser
depuis	PRP	depuis
l'	DET:ART	le
achat	NOM	achat
...	PUN	...
par	PRP	par
contre	PRP	contre
depuis	PRP	depuis
la	DET:ART	le
dernière	ADJ	dernier
mise	NOM	mise
à	PRP	à
jour	NOM	jour
l'	DET:ART	le
application	NOM	application
me	PRO:PER	me
dit	VER:pres	dire
que	KON	que
sa	DET:POS	son
ne	ADV	ne
trouve	VER:pres	trouver
pas	ADV	pas
le	DET:ART	le
gps	NOM	<unknown>
:	PUN	:
-(	ADJ	<unknown>
alors	ADV	alors
que	KON	que
toutes	PRO:IND	tout
les	DET:ART	le
autres	ADJ	autre
applications	NOM	application
fonctionne	VER:pres	fonctionner
très	ADV	très
bien	ADV	bien
...	PUN	...
merci	NOM	merci
de	PRP	de
régler	VER:infi	régler
ça	PRO:DEM	cela
au	PRP:det	au
plus	ADV	plus
vite	ADV	vite
icoyote	NOM	<unknown>
.	SENT	.
Samsung	NOM	<unknown>
galaxy	NOM	<unknown>
s3	ADJ	<unknown>
4g	NOM	<unknown>
DateCommentaire:27	ABR	<unknown>
septembre	NOM	septembre
2014	NUM	@card@
NoteCommentaire:3	ABR	<unknown>
