NomApplication	NAM	<unknown>
:	PUN	:
eBay	NOM	<unknown>
IdApplication	NAM	<unknown>
:	PUN	:
com	NOM	<unknown>
.	SENT	.
ebay	NOM	<unknown>
.	SENT	.
mobile	ADJ	mobile
CategorieApplication	NOM	<unknown>
:	PUN	:
Shopping	NOM	shopping
NoteApplication:4,3	NAM	<unknown>
NombreVotants:1	ABR	<unknown>
084	NUM	@card@
381	NUM	@card@
TitreCommentaire	NAM	<unknown>
:	PUN	:
Ebay	NAM	<unknown>
Commentaire	NAM	<unknown>
:	PUN	:
Simplement	ADV	simplement
superbe	ADJ	superbe
.	SENT	.
Toujours	ADV	toujours
mieux	ADV	mieux
.	SENT	.
DateCommentaire:20	ABR	<unknown>
novembre	NOM	novembre
2014	NUM	@card@
NoteCommentaire:5	ABR	<unknown>
