NomApplication	NAM	<unknown>
:	PUN	:
SNCF	ABR	SNCF
Transilien	NAM	<unknown>
IdApplication	NAM	<unknown>
:	PUN	:
com	NOM	<unknown>
.	SENT	.
ocito	NOM	<unknown>
.	SENT	.
sncf	NOM	<unknown>
CategorieApplication	NAM	<unknown>
:	PUN	:
Transports	NOM	transport
NoteApplication:3,8	NAM	<unknown>
NombreVotants:5	ABR	<unknown>
271	NUM	@card@
TitreCommentaire	NOM	<unknown>
:	PUN	:
Prochains	ADJ	prochain
trains	NOM	train
Commentaire	ADJ	<unknown>
:	PUN	:
Les	DET:ART	le
horaires	NOM	horaire
des	PRP:det	du
Prochains	NAM	<unknown>
trains	NOM	train
ne	ADV	ne
sont	VER:pres	être
plus	ADV	plus
disponibles	ADJ	disponible
depuis	PRP	depuis
l	VER:infi	<unknown>
été	VER:pper	être
2014	NUM	@card@
comment	ADV	comment
taire	VER:infi	taire
DateCommentaire:3	ADJ	<unknown>
novembre	NOM	novembre
2014	NUM	@card@
NoteCommentaire:2	ABR	<unknown>
