NomApplication	NAM	<unknown>
:	PUN	:
Spotify	NAM	<unknown>
Music	NAM	<unknown>
IdApplication	NAM	<unknown>
:	PUN	:
com	NOM	<unknown>
.	SENT	.
spotify	NOM	<unknown>
.	SENT	.
music	NOM	<unknown>
CategorieApplication	NAM	<unknown>
:	PUN	:
Musique	NOM	musique
et	KON	et
audio	NOM	<unknown>
NoteApplication:4,5	ABR	<unknown>
NombreVotants:1	ABR	<unknown>
828	NUM	@card@
796	NUM	@card@
TitreCommentaire	NOM	<unknown>
:	PUN	:
Commentaire	NOM	commentaire
:	PUN	:
Problème	NOM	problème
récurrent	ADJ	récurrent
,	PUN	,
on	PRO:PER	on
ne	ADV	ne
peut	VER:pres	pouvoir
pas	ADV	pas
choisir	VER:infi	choisir
le	DET:ART	le
morceau	NOM	morceau
qu'	PRO:REL	que
on	PRO:PER	on
veut	VER:pres	vouloir
écouter	VER:infi	écouter
mais	KON	mais
uniquement	ADV	uniquement
lecture	NOM	lecture
aléatoire	ADJ	aléatoire
...	PUN	...
DateCommentaire:19	ABR	<unknown>
novembre	NOM	novembre
2014	NUM	@card@
NoteCommentaire:1	ABR	<unknown>
