NomApplication	NAM	<unknown>
:	PUN	:
CANAL	NOM	canal
RUGBY	NAM	<unknown>
APP	NAM	<unknown>
IdApplication	NAM	<unknown>
:	PUN	:
com	NOM	<unknown>
.	SENT	.
netcosports	NOM	<unknown>
.	SENT	.
andcanalrugby	NOM	<unknown>
CategorieApplication	NAM	<unknown>
:	PUN	:
Sports	NOM	sport
NoteApplication:4,2	NAM	<unknown>
NombreVotants:855	NAM	<unknown>
TitreCommentaire	NAM	<unknown>
:	PUN	:
Bien	ADV	bien
Commentaire	ADJ	<unknown>
:	PUN	:
Dommage	NOM	dommage
que	PRO:REL	que
,	PUN	,
il	PRO:PER	il
faut	VER:pres	falloir
un	DET:ART	un
copte	ADJ	copte
canal	NOM	canal
plus	ADV	plus
pour	PRP	pour
revoir	VER:infi	revoir
les	DET:ART	le
match	NOM	match
DateCommentaire:17	ABR	<unknown>
janvier	NOM	janvier
2014	NUM	@card@
NoteCommentaire:4	ABR	<unknown>
