NomApplication	NAM	<unknown>
:	PUN	:
Photo	NOM	photo
Collage	NAM	<unknown>
éditeur	NOM	éditeur
IdApplication	NOM	<unknown>
:	PUN	:
com	NOM	<unknown>
.	SENT	.
zentertain	NOM	<unknown>
.	SENT	.
photocollage	NOM	<unknown>
CategorieApplication	NAM	<unknown>
:	PUN	:
Photographie	NOM	photographie
NoteApplication:4,2	NAM	<unknown>
NombreVotants:231	ABR	<unknown>
243	NUM	@card@
TitreCommentaire	NOM	<unknown>
:	PUN	:
Commentaire	NOM	commentaire
:	PUN	:
Trop	ADV	trop
de	PRP	de
bug	NOM	<unknown>
sur	PRP	sur
tout	PRO:IND	tout
le	DET:ART	le
portable	ADJ	portable
meme	NOM	<unknown>
quang	ADJ	<unknown>
je	PRO:PER	je
ne	ADV	ne
suis	VER:pres	suivre|être
plus	ADV	plus
sur	PRP	sur
l	ADJ	<unknown>
apli	NOM	<unknown>
DateCommentaire:22	ABR	<unknown>
novembre	NOM	novembre
2014	NUM	@card@
NoteCommentaire:3	ABR	<unknown>
