NomApplication	NAM	<unknown>
:	PUN	:
DIY	NAM	<unknown>
Locker	NAM	<unknown>
-	PUN	-
Tattoo	NAM	<unknown>
Locker	NAM	<unknown>
IdApplication	NAM	<unknown>
:	PUN	:
com	NOM	<unknown>
.	SENT	.
ztapps	NOM	<unknown>
.	SENT	.
lockermaster	NOM	<unknown>
CategorieApplication	NAM	<unknown>
:	PUN	:
Personnalisation	NOM	personnalisation
NoteApplication:4,4	NAM	<unknown>
NombreVotants:96	ABR	<unknown>
959	NUM	@card@
TitreCommentaire	NOM	<unknown>
:	PUN	:
Application	NOM	application
parfaite	VER:pper	parfaire
Commentaire	ADJ	<unknown>
:	PUN	:
C'	PRO:DEM	ce
est	VER:pres	être
vraiment	ADV	vraiment
bien	ADV	bien
quand	KON	quand
on	PRO:PER	on
veut	VER:pres	vouloir
personnalisé	VER:pper	personnaliser
son	DET:POS	son
déverrouillage	NOM	déverrouillage
plutôt	ADV	plutôt
que	KON	que
celui	PRO:DEM	celui
d'	PRP	de
origine	NOM	origine
peu	ADV	peu
personnalisable	ADJ	<unknown>
♥	NOM	<unknown>
DateCommentaire:23	ABR	<unknown>
novembre	NOM	novembre
2014	NUM	@card@
NoteCommentaire:5	ABR	<unknown>
