NomApplication	NAM	<unknown>
:	PUN	:
Music	NAM	<unknown>
Tube	NAM	<unknown>
IdApplication	NAM	<unknown>
:	PUN	:
com	NOM	<unknown>
.	SENT	.
appraton	NOM	<unknown>
.	SENT	.
musictube	NOM	<unknown>
CategorieApplication	NAM	<unknown>
:	PUN	:
Musique	NOM	musique
et	KON	et
audio	NOM	<unknown>
NoteApplication:3,7	ABR	<unknown>
NombreVotants:7	ABR	<unknown>
484	NUM	@card@
TitreCommentaire	NOM	<unknown>
:	PUN	:
Commentaire	NOM	commentaire
:	PUN	:
La	DET:ART	le
merde	NOM	merde
trop	ADV	trop
de	PRP	de
beug	NOM	<unknown>
sur	PRP	sur
tablete	NOM	<unknown>
DateCommentaire:17	ABR	<unknown>
novembre	NOM	novembre
2014	NUM	@card@
NoteCommentaire:1	ABR	<unknown>
