NomApplication	NAM	<unknown>
:	PUN	:
Marmiton	NOM	marmiton
Tablette	NAM	<unknown>
:	PUN	:
recettes	NOM	recette
IdApplication	NAM	<unknown>
:	PUN	:
com	NOM	<unknown>
.	SENT	.
aufeminin	NOM	<unknown>
.	SENT	.
marmiton	NOM	marmiton
.	SENT	.
tablet	NOM	<unknown>
CategorieApplication	NAM	<unknown>
:	PUN	:
Style	NOM	style
de	PRP	de
vie	NOM	vie
NoteApplication:4,2	ABR	<unknown>
NombreVotants:16	ABR	<unknown>
635	NUM	@card@
TitreCommentaire	NOM	<unknown>
:	PUN	:
Commentaire	NOM	commentaire
:	PUN	:
uper	NOM	<unknown>
top	NOM	top
l	VER:subi	<unknown>
idee	NOM	<unknown>
d	VER:subi	<unknown>
une	DET:ART	un
nouvelle	ADJ	nouveau
recette	NOM	recette
par	PRP	par
jour	NOM	jour
.	SENT	.
Recherches	NOM	recherche
faciles	ADJ	facile
,	PUN	,
carnet	NOM	carnet
qui	PRO:REL	qui
se	PRO:PER	se
remplit	VER:pres	remplir
de	PRP	de
bonnes	ADJ	bon
idees	NOM	<unknown>
...	PUN	...
merci	NOM	merci
marmiton	NOM	marmiton
DateCommentaire:9	ABR	<unknown>
octobre	NOM	octobre
2014	NUM	@card@
NoteCommentaire:5	ABR	<unknown>
