NomApplication	NAM	<unknown>
:	PUN	:
Wallapop	NAM	<unknown>
-	PUN	-
Acheter	NAM	<unknown>
et	KON	et
vendre	VER:infi	vendre
IdApplication	NOM	<unknown>
:	PUN	:
com	NOM	<unknown>
.	SENT	.
wallapop	NOM	<unknown>
CategorieApplication	NAM	<unknown>
:	PUN	:
Shopping	NOM	shopping
NoteApplication:4,0	NAM	<unknown>
NombreVotants:37	ABR	<unknown>
191	NUM	@card@
TitreCommentaire	NOM	<unknown>
:	PUN	:
Pas	ADV	pas
mal	ADV	mal
Commentaire	ADJ	<unknown>
:	PUN	:
Bonne	ADJ	bon
idée	NOM	idée
et	KON	et
bien	ADV	bien
fait	VER:pper	faire
mais	KON	mais
quelques	PRO:IND	quelque
bug	NOM	<unknown>
.	SENT	.
Quand	KON	quand
je	PRO:PER	je
tape	VER:pres	taper
une	DET:ART	un
recherche	NOM	recherche
de	PRP	de
vélo	NOM	vélo
je	PRO:PER	je
tombe	VER:pres	tomber
sur	PRP	sur
des	PRP:det	du
robes	NOM	robe
de	PRP	de
mariée	NOM	marié
...	PUN	...
DateCommentaire:19	ABR	<unknown>
novembre	NOM	novembre
2014	NUM	@card@
NoteCommentaire:3	ABR	<unknown>
