NomApplication	NAM	<unknown>
:	PUN	:
Dictionnaire	NOM	dictionnaire
Anglais-Français	NAM	<unknown>
IdApplication	NAM	<unknown>
:	PUN	:
com	NOM	<unknown>
.	SENT	.
dic_o	NOM	<unknown>
.	SENT	.
dico_eng_fra	ADJ	<unknown>
CategorieApplication	NOM	<unknown>
:	PUN	:
Livres	NOM	livre
et	KON	et
références	NOM	référence
NoteApplication:3,9	ABR	<unknown>
NombreVotants:11	ABR	<unknown>
132	NUM	@card@
TitreCommentaire	NOM	<unknown>
:	PUN	:
Dico	NOM	dico
Anglo/franco	NAM	<unknown>
Commentaire	NAM	<unknown>
:	PUN	:
it'a	VER:simp	<unknown>
cool/c'est	NOM	<unknown>
cool	ADJ	cool
DateCommentaire:26	ADJ	<unknown>
mars	NOM	mars
2013	NUM	@card@
NoteCommentaire:5	ABR	<unknown>
