NomApplication	NAM	<unknown>
:	PUN	:
La	DET:ART	le
Chaîne	NAM	<unknown>
Météo	NAM	<unknown>
IdApplication	NAM	<unknown>
:	PUN	:
com	NOM	<unknown>
.	SENT	.
lachainemeteo	NOM	<unknown>
.	SENT	.
androidapp	NOM	<unknown>
CategorieApplication	NAM	<unknown>
:	PUN	:
Météo	NOM	météo
NoteApplication:4,3	NAM	<unknown>
NombreVotants:87	ABR	<unknown>
250	NUM	@card@
TitreCommentaire	NOM	<unknown>
:	PUN	:
Application	NOM	application
devenu	VER:pper	devenir
complexe	ADJ	complexe
Commentaire	NAM	<unknown>
:	PUN	:
Application	NOM	application
étant	VER:ppre	être
devenue	VER:pper	devenir
beaucoup	ADV	beaucoup
plus	ADV	plus
complexe	ADJ	complexe
,	PUN	,
consomment	VER:pres	consommer
énormément	ADV	énormément
de	PRP	de
batterie	NOM	batterie
et	KON	et
devenue	VER:pper	devenir
très	ADV	très
lente	ADJ	lent
.	SENT	.
C'	PRO:DEM	ce
était	VER:impf	être
mieux	ADV	mieux
avant	PRP	avant
la	DET:ART	le
mise	NOM	mise
a	VER:pres	avoir
jour	NOM	jour
.	SENT	.
DateCommentaire:29	ABR	<unknown>
août	NOM	août
2014	NUM	@card@
NoteCommentaire:3	ABR	<unknown>
