NomApplication	NAM	<unknown>
:	PUN	:
Fotor	NAM	<unknown>
Photo	NAM	<unknown>
Editor	NAM	<unknown>
IdApplication	NAM	<unknown>
:	PUN	:
com	NOM	<unknown>
.	SENT	.
everimaging	NOM	<unknown>
.	SENT	.
photoeffectstudio	NOM	<unknown>
CategorieApplication	NAM	<unknown>
:	PUN	:
Photographie	NOM	photographie
NoteApplication:4,4	NAM	<unknown>
NombreVotants:103	ABR	<unknown>
334	NUM	@card@
TitreCommentaire	NOM	<unknown>
:	PUN	:
Commentaire	NOM	commentaire
:	PUN	:
Simple	ADJ	simple
et	KON	et
ludique	ADJ	ludique
DateCommentaire:16	NOM	<unknown>
novembre	NOM	novembre
2014	NUM	@card@
NoteCommentaire:5	ABR	<unknown>
