NomApplication	NAM	<unknown>
:	PUN	:
Darty	NAM	<unknown>
IdApplication	NAM	<unknown>
:	PUN	:
com	NOM	<unknown>
.	SENT	.
darty	NOM	<unknown>
.	SENT	.
catalogue	NOM	catalogue
CategorieApplication	NAM	<unknown>
:	PUN	:
Shopping	NOM	shopping
NoteApplication:3,9	NAM	<unknown>
NombreVotants:1	ABR	<unknown>
451	NUM	@card@
TitreCommentaire	NOM	<unknown>
:	PUN	:
Ne	ADV	ne
mérite	VER:pres	mériter
même	ADV	même
pas	ADV	pas
une	DET:ART	un
étoile	NOM	étoile
Commentaire	ADJ	<unknown>
:	PUN	:
Plante	VER:pres	planter
tout	ADV	tout
le	DET:ART	le
temps	NOM	temps
.	SENT	.
Passer	VER:infi	passer
votre	DET:POS	votre
chemin	NOM	chemin
et	KON	et
aller	VER:infi	aller
directement	ADV	directement
sur	PRP	sur
le	DET:ART	le
site	NOM	site
si	KON	si
vous	PRO:PER	vous
voulez	VER:pres	vouloir
passer	VER:infi	passer
commande	NOM	commande
.	SENT	.
DateCommentaire:28	ABR	<unknown>
juillet	NOM	juillet
2014	NUM	@card@
NoteCommentaire:1	ABR	<unknown>
