NomApplication	NAM	<unknown>
:	PUN	:
Minuteur	NOM	minuteur
d'	PRP	de
exercice	NOM	exercice
IdApplication	NOM	<unknown>
:	PUN	:
com	NOM	<unknown>
.	SENT	.
neurondigital	NOM	<unknown>
.	SENT	.
exercisetimer	NOM	<unknown>
CategorieApplication	NAM	<unknown>
:	PUN	:
Sports	NOM	sport
NoteApplication:4,1	NAM	<unknown>
NombreVotants:1	ABR	<unknown>
381	NUM	@card@
TitreCommentaire	NOM	<unknown>
:	PUN	:
Excellent	ADJ	excellent
minuteur	NOM	minuteur
Commentaire	ADJ	<unknown>
:	PUN	:
Bon	ADJ	bon
timer	NOM	<unknown>
modification	NOM	modification
simple	ADJ	simple
facile	ADJ	facile
de	PRP	de
utilisation	NOM	utilisation
DateCommentaire:11	ABR	<unknown>
septembre	NOM	septembre
2014	NUM	@card@
NoteCommentaire:5	ABR	<unknown>
