NomApplication	NAM	<unknown>
:	PUN	:
Napster	NAM	<unknown>
IdApplication	NAM	<unknown>
:	PUN	:
com	NOM	<unknown>
.	SENT	.
rhapsody	NOM	<unknown>
.	SENT	.
napster	NOM	<unknown>
CategorieApplication	NAM	<unknown>
:	PUN	:
Musique	NOM	musique
et	KON	et
audio	NOM	<unknown>
NoteApplication:3,8	ABR	<unknown>
NombreVotants:10	ABR	<unknown>
696	NUM	@card@
TitreCommentaire	NOM	<unknown>
:	PUN	:
Peu	ADV	peu
mieux	ADV	mieux
faire	VER:infi	faire
Commentaire	NAM	<unknown>
:	PUN	:
Manque	VER:pres	manquer
certains	PRO:IND	certain
artistes	NOM	artiste
connus.	VER:pper	<unknown>
.	SENT	.
exemple	NOM	exemple
"	PUN:cit	"
Jul	NAM	<unknown>
"	PUN:cit	"
et	KON	et
Divers	NAM	<unknown>
begue	NOM	<unknown>
sur	PRP	sur
Samsung	NAM	<unknown>
Galaxy	NAM	<unknown>
Grand	NAM	<unknown>
2	NUM	@card@
et	KON	et
Wiko	NAM	<unknown>
Gateway	NAM	<unknown>
DateCommentaire:19	ABR	<unknown>
novembre	NOM	novembre
2014	NUM	@card@
NoteCommentaire:2	ABR	<unknown>
