NomApplication	NAM	<unknown>
:	PUN	:
Ebook	NOM	<unknown>
Reader	NAM	<unknown>
IdApplication	NAM	<unknown>
:	PUN	:
com	NOM	<unknown>
.	SENT	.
ebooks	NOM	<unknown>
.	SENT	.
ebookreader	NOM	<unknown>
CategorieApplication	NAM	<unknown>
:	PUN	:
Livres	NOM	livre
et	KON	et
références	NOM	référence
NoteApplication:4,0	ABR	<unknown>
NombreVotants:30	ABR	<unknown>
571	NUM	@card@
TitreCommentaire	NAM	<unknown>
:	PUN	:
Nice	NAM	Nice
Commentaire	NAM	<unknown>
:	PUN	:
I	NUM	I
like	NOM	<unknown>
this	NOM	<unknown>
very	ADJ	<unknown>
useful	ADJ	<unknown>
app	NOM	<unknown>
,	PUN	,
even	NOM	<unknown>
though	NOM	<unknown>
its	VER:subi	<unknown>
10	NUM	@card@
%	SYM	%
slow	NOM	slow
DateCommentaire:20	ABR	<unknown>
octobre	NOM	octobre
2014	NUM	@card@
NoteCommentaire:4	ABR	<unknown>
