NomApplication	NAM	<unknown>
:	PUN	:
Météo	NOM	météo
Paris	NAM	Paris
IdApplication	NAM	<unknown>
:	PUN	:
com	NOM	<unknown>
.	SENT	.
meteo	NOM	<unknown>
.	SENT	.
android	NOM	<unknown>
CategorieApplication	NAM	<unknown>
:	PUN	:
Météo	NOM	météo
NoteApplication:4,5	NAM	<unknown>
NombreVotants:4	ABR	<unknown>
677	NUM	@card@
TitreCommentaire	NOM	<unknown>
:	PUN	:
Super	ADJ	super
Commentaire	NAM	<unknown>
:	PUN	:
Les	DET:ART	le
prévisions	NOM	prévision
sont	VER:pres	être
fiables	ADJ	fiable
.	SENT	.
Très	ADV	très
belle	ADJ	beau
interface	NOM	interface
.	SENT	.
Bravo	INT	bravo
aux	PRP:det	au
développeurs	NOM	<unknown>
.	SENT	.
DateCommentaire:24	ABR	<unknown>
octobre	NOM	octobre
2014	NUM	@card@
NoteCommentaire:5	ABR	<unknown>
