NomApplication	NAM	<unknown>
:	PUN	:
Dailymotion	NAM	<unknown>
IdApplication	NAM	<unknown>
:	PUN	:
com	NOM	<unknown>
.	SENT	.
dailymotion	NOM	<unknown>
.	SENT	.
dailymotion	NOM	<unknown>
CategorieApplication	NAM	<unknown>
:	PUN	:
Divertissement	NOM	divertissement
NoteApplication:4,2	NAM	<unknown>
NombreVotants:302	ABR	<unknown>
716	NUM	@card@
TitreCommentaire	NOM	<unknown>
:	PUN	:
Trop	ADV	trop
de	PRP	de
pub	NOM	pub
Commentaire	ADJ	<unknown>
:	PUN	:
Bonne	ADJ	bon
appli	NOM	<unknown>
qui	PRO:REL	qui
marche	VER:pres	marcher
bien	ADV	bien
mais	KON	mais
les	DET:ART	le
pubs	NOM	pub
trop	ADV	trop
longues	ADJ	longue
avant	PRP	avant
les	DET:ART	le
vidéos	NOM	vidéo
gâchent	VER:pres	gâcher
le	DET:ART	le
plaisir	NOM	plaisir
DateCommentaire:18	ABR	<unknown>
novembre	NOM	novembre
2014	NUM	@card@
NoteCommentaire:3	ABR	<unknown>
