NomApplication	NAM	<unknown>
:	PUN	:
The	NAM	<unknown>
Voice	NAM	<unknown>
:	PUN	:
On	PRO:PER	on
Stage	NOM	stage
IdApplication	NOM	<unknown>
:	PUN	:
com	NOM	<unknown>
.	SENT	.
starmakerinteractive	ADJ	<unknown>
.	SENT	.
thevoice	NOM	<unknown>
CategorieApplication	NAM	<unknown>
:	PUN	:
Musique	NOM	musique
et	KON	et
audio	NOM	<unknown>
NoteApplication:3,9	ABR	<unknown>
NombreVotants:97	ABR	<unknown>
716	NUM	@card@
TitreCommentaire	NAM	<unknown>
:	PUN	:
Jadore	NAM	<unknown>
Commentaire	NAM	<unknown>
:	PUN	:
Jadore	NAM	<unknown>
cette	PRO:DEM	ce
applis	NOM	<unknown>
elle	PRO:PER	elle
est	VER:pres	être
cool	ADJ	cool
cool	NOM	cool
cool	ADJ	cool
je	PRO:PER	je
l	VER:futu	<unknown>
adore	VER:pres	adorer
♥♥♥	NOM	<unknown>
jesuis	VER:pres	<unknown>
tt	VER:pper	<unknown>
le	DET:ART	le
temps	NOM	temps
dessus	ADV	dessus
♥♥♥♥jadore	VER:subp	<unknown>
encore	ADV	encore
et	KON	et
encore	ADV	encore
jadore	NOM	<unknown>
!	SENT	!
DateCommentaire:4	ABR	<unknown>
octobre	NOM	octobre
2014	NUM	@card@
NoteCommentaire:5	ABR	<unknown>
