NomApplication	NAM	<unknown>
:	PUN	:
Candy	NAM	<unknown>
Camera	NAM	<unknown>
-	PUN	-
Selfie	NAM	<unknown>
Selfies	NAM	<unknown>
IdApplication	NAM	<unknown>
:	PUN	:
com	NOM	<unknown>
.	SENT	.
joeware	NOM	<unknown>
.	SENT	.
android	NOM	<unknown>
.	SENT	.
gpulumera	VER:futu	<unknown>
CategorieApplication	NOM	<unknown>
:	PUN	:
Photographie	NOM	photographie
NoteApplication:4,3	NAM	<unknown>
NombreVotants:680	ABR	<unknown>
831	NUM	@card@
TitreCommentaire	NOM	<unknown>
:	PUN	:
Pas	ADV	pas
mal	ADJ	mal
!	SENT	!
Commentaire	NOM	commentaire
:	PUN	:
Quelqu'un	PRO:IND	quelqu'un
peut	VER:pres	pouvoir
m'	PRO:PER	me
expliquer	VER:infi	expliquer
comment	ADV	comment
on	PRO:PER	on
fait	VER:pres	faire
pour	PRP	pour
avoir	VER:infi	avoir
mes	DET:POS	mon
trucs	NOM	truc
sur	PRP	sur
eye	NOM	<unknown>
liner	NOM	liner
,	PUN	,
fare	NOM	fare
a	VER:pres	avoir
joue	NOM	joue
etc	ABR	etc
!	SENT	!
üòòüòúüëç	ABR	<unknown>
DateCommentaire:29	ABR	<unknown>
octobre	NOM	octobre
2014	NUM	@card@
NoteCommentaire:3	ABR	<unknown>
