NomApplication	NOM	<unknown>
:	PUN	:
Météo	ADJ	météo
pour	PRP	pour
la	DET:ART	le
France	NAM	France
IdApplication	NAM	<unknown>
:	PUN	:
com	NOM	<unknown>
.	SENT	.
idmobile	NOM	<unknown>
.	SENT	.
francemeteo	NOM	<unknown>
CategorieApplication	NAM	<unknown>
:	PUN	:
Météo	NOM	météo
NoteApplication:4,5	NAM	<unknown>
NombreVotants:43	ABR	<unknown>
655	NUM	@card@
TitreCommentaire	NAM	<unknown>
:	PUN	:
Stéph34	NAM	<unknown>
Commentaire	NAM	<unknown>
:	PUN	:
Trop	ADV	trop
bonne	ADJ	bon
application	NOM	application
et	KON	et
beaucpup	NOM	<unknown>
plus	ADV	plus
belle	ADJ	beau
que	KON	que
la	DET:ART	le
dernière	ADJ	dernier
version	NOM	version
.	SENT	.
Bravo	INT	bravo
.	SENT	.
DateCommentaire:9	ABR	<unknown>
novembre	NOM	novembre
2014	NUM	@card@
NoteCommentaire:4	ABR	<unknown>
