NomApplication	NAM	<unknown>
:	PUN	:
Flipagram	NAM	<unknown>
IdApplication	NAM	<unknown>
:	PUN	:
com	NOM	<unknown>
.	SENT	.
cheerfulinc	NOM	<unknown>
.	SENT	.
flipagram	NOM	<unknown>
CategorieApplication	NAM	<unknown>
:	PUN	:
Photographie	NOM	photographie
NoteApplication:4,4	NAM	<unknown>
NombreVotants:784	ABR	<unknown>
775	NUM	@card@
TitreCommentaire	NOM	<unknown>
:	PUN	:
Commentaire	NOM	commentaire
:	PUN	:
J'	PRO:PER	je
utilise	VER:pres	utiliser
beaucoup	ADV	beaucoup
cet	PRO:DEM	ce
applic	NOM	<unknown>
pour	PRP	pour
Instagram	NOM	<unknown>
,	PUN	,
tout	ADV	tout
pourrait	VER:cond	pouvoir
être	VER:infi	être
parfait	ADJ	parfait
mais	KON	mais
...	PUN	...
gros	ADV	gros
problème	NOM	problème
:	PUN	:
le	DET:ART	le
noir	ADJ	noir
et	KON	et
blanc	ADJ	blanc
des	PRP:det	du
photos	NOM	photo
d'	PRP	de
origine	NOM	origine
est	VER:pres	être
complètement	ADV	complètement
détérioré	VER:pper	détériorer
durant	PRP	durant
le	DET:ART	le
montage	NOM	montage
vidéo	ADJ	vidéo
,	PUN	,
donnant	VER:ppre	donner
un	DET:ART	un
aspect	NOM	aspect
verdâtre	ADJ	verdâtre
:	PUN	:
(	PUN	(
(	PUN	(
DateCommentaire:26	ABR	<unknown>
octobre	NOM	octobre
2014	NUM	@card@
NoteCommentaire:3	ABR	<unknown>
