NomApplication	NOM	<unknown>
:	PUN	:
Ben	ADV	ben
le	DET:ART	le
chien	NOM	chien
qui	PRO:REL	qui
parle	VER:pres	parler
gratuit	ADJ	gratuit
IdApplication	NOM	<unknown>
:	PUN	:
com	NOM	<unknown>
.	SENT	.
outfit7	NOM	<unknown>
.	SENT	.
talkingben	NOM	<unknown>
CategorieApplication	NAM	<unknown>
:	PUN	:
Divertissement	NOM	divertissement
NoteApplication:4,3	NAM	<unknown>
NombreVotants:811	ABR	<unknown>
057	NUM	@card@
TitreCommentaire	NOM	<unknown>
:	PUN	:
Cool	NOM	cool
Commentaire	NAM	<unknown>
:	PUN	:
Cool	ADJ	cool
mais	KON	mais
on	PRO:PER	on
ne	ADV	ne
peut	VER:pres	pouvoir
pas	ADV	pas
faire	VER:infi	faire
grand	ADJ	grand
chose	NOM	chose
DateCommentaire:17	ABR	<unknown>
octobre	NOM	octobre
2014	NUM	@card@
NoteCommentaire:5	ABR	<unknown>
