NomApplication	NAM	<unknown>
:	PUN	:
Piano	NOM	piano
For	NAM	<unknown>
You	NAM	<unknown>
IdApplication	NAM	<unknown>
:	PUN	:
com	NOM	<unknown>
.	SENT	.
pash	NOM	<unknown>
.	SENT	.
piano	ADV	piano
CategorieApplication	NAM	<unknown>
:	PUN	:
Musique	NOM	musique
et	KON	et
audio	NOM	<unknown>
NoteApplication:4,3	ABR	<unknown>
NombreVotants:15	ABR	<unknown>
535	NUM	@card@
TitreCommentaire	NOM	<unknown>
:	PUN	:
Je	PRO:PER	je
deviens	VER:pres	devenir
Mozart	NAM	Mozart
Commentaire	NAM	<unknown>
:	PUN	:
merci	NOM	merci
a	VER:pres	avoir
appgratis	VER:pper	<unknown>
Grâce	NAM	<unknown>
a	VER:pres	avoir
cette	PRO:DEM	ce
superbe	ADJ	superbe
application	NOM	application
gé	VER:subi	<unknown>
retrouver	VER:infi	retrouver
une	DET:ART	un
véritable	ADJ	véritable
libido	NOM	libido
avec	PRP	avec
menottes	NOM	menotte
et	KON	et
fouet	NOM	fouet
car	KON	car
jouant	VER:ppre	jouer
lamentablement	ADV	lamentablement
j	ADJ	<unknown>
attire	VER:pres	attirer
le	PRO:PER	le
mon	DET:POS	mon
SM	NAM	<unknown>
.	SENT	.
DateCommentaire:13	ABR	<unknown>
septembre	NOM	septembre
2013	NUM	@card@
NoteCommentaire:4	ABR	<unknown>
