NomApplication	NAM	<unknown>
:	PUN	:
AlloCine	NAM	<unknown>
IdApplication	NAM	<unknown>
:	PUN	:
com	NOM	<unknown>
.	SENT	.
allocine	NOM	<unknown>
.	SENT	.
androidapp	NOM	<unknown>
CategorieApplication	NAM	<unknown>
:	PUN	:
Divertissement	NOM	divertissement
NoteApplication:3,9	NAM	<unknown>
NombreVotants:35	ABR	<unknown>
475	NUM	@card@
TitreCommentaire	NOM	<unknown>
:	PUN	:
Du	PRP:det	du
mieux	ADV	mieux
!	SENT	!
Commentaire	NOM	commentaire
:	PUN	:
les	DET:ART	le
bugs	NOM	<unknown>
sont	VER:pres	être
maintenant	ADV	maintenant
généralement	ADV	généralement
résolus	VER:pper	résoudre
.	SENT	.
DateCommentaire:16	ABR	<unknown>
novembre	NOM	novembre
2014	NUM	@card@
NoteCommentaire:4	ABR	<unknown>
