NomApplication	NAM	<unknown>
:	PUN	:
Kindle	NAM	<unknown>
IdApplication	NAM	<unknown>
:	PUN	:
com	NOM	<unknown>
.	SENT	.
amazon	NOM	<unknown>
.	SENT	.
kindle	NOM	<unknown>
CategorieApplication	NAM	<unknown>
:	PUN	:
Livres	NOM	livre
et	KON	et
références	NOM	référence
NoteApplication:4,1	ABR	<unknown>
NombreVotants:354	ABR	<unknown>
441	NUM	@card@
TitreCommentaire	NOM	<unknown>
:	PUN	:
Bon	ADJ	bon
Commentaire	NOM	commentaire
:	PUN	:
Super	ADJ	super
marche	NOM	marche
a	VER:pres	avoir
merveille	NOM	merveille
DateCommentaire:17	ABR	<unknown>
octobre	NOM	octobre
2014	NUM	@card@
NoteCommentaire:5	ABR	<unknown>
