NomApplication	NAM	<unknown>
:	PUN	:
Moon+	NAM	<unknown>
Reader	NAM	<unknown>
IdApplication	NAM	<unknown>
:	PUN	:
com	NOM	<unknown>
.	SENT	.
flyersoft	NOM	<unknown>
.	SENT	.
moonreader	NOM	<unknown>
CategorieApplication	NAM	<unknown>
:	PUN	:
Livres	NOM	livre
et	KON	et
références	NOM	référence
NoteApplication:4,5	ABR	<unknown>
NombreVotants:168	ABR	<unknown>
588	NUM	@card@
TitreCommentaire	NOM	<unknown>
:	PUN	:
Vraiment	ADV	vraiment
bien	ADV	bien
mais	KON	mais
...	PUN	...
Commentaire	NAM	<unknown>
:	PUN	:
Un	DET:ART	un
meilleur	ADJ	meilleur
signalement	NOM	signalement
des	PRP:det	du
prises	NOM	prise
de	PRP	de
notes	NOM	note
serait	VER:cond	être
nécessaire	ADJ	nécessaire
.	SENT	.
Le	DET:ART	le
malheureux	NOM	malheureux
postit	VER:simp	<unknown>
fait	VER:pper	faire
pitié	NOM	pitié
DateCommentaire:7	ABR	<unknown>
novembre	NOM	novembre
2014	NUM	@card@
NoteCommentaire:4	ABR	<unknown>
