NomApplication	NAM	<unknown>
:	PUN	:
Talking	NAM	<unknown>
Tom	NAM	<unknown>
Cat	NAM	<unknown>
2	NUM	@card@
Free	NOM	<unknown>
IdApplication	NOM	<unknown>
:	PUN	:
com	NOM	<unknown>
.	SENT	.
outfit7	NOM	<unknown>
.	SENT	.
talkingtom2free	NOM	<unknown>
CategorieApplication	NAM	<unknown>
:	PUN	:
Divertissement	NOM	divertissement
NoteApplication:4,4	NAM	<unknown>
NombreVotants:1	ABR	<unknown>
886	NUM	@card@
406	NUM	@card@
TitreCommentaire	NAM	<unknown>
:	PUN	:
Genial	NAM	<unknown>
Commentaire	NAM	<unknown>
:	PUN	:
Mon	DET:POS	mon
petit	ADJ	petit
frère	NOM	frère
s'	PRO:PER	se
eclate	VER:pres	<unknown>
avec	PRP	avec
cette	PRO:DEM	ce
aplication	NOM	<unknown>
.	SENT	.
Il	PRO:PER	il
rigole	VER:pres	rigoler
beaucoup	ADV	beaucoup
...	PUN	...
DateCommentaire:13	ABR	<unknown>
septembre	NOM	septembre
2014	NUM	@card@
NoteCommentaire:5	ABR	<unknown>
