NomApplication	NAM	<unknown>
:	PUN	:
Akinator	NAM	<unknown>
the	VER:simp	<unknown>
Genie	NAM	<unknown>
FREE	NAM	<unknown>
IdApplication	NAM	<unknown>
:	PUN	:
com	NOM	<unknown>
.	SENT	.
digidust	NOM	<unknown>
.	SENT	.
elokence	NOM	<unknown>
.	SENT	.
akinator	NOM	<unknown>
.	SENT	.
freemium	NOM	<unknown>
CategorieApplication	NAM	<unknown>
:	PUN	:
Divertissement	NOM	divertissement
NoteApplication:4,2	NAM	<unknown>
NombreVotants:356	ABR	<unknown>
769	NUM	@card@
TitreCommentaire	NAM	<unknown>
:	PUN	:
Bug	NAM	<unknown>
Commentaire	NAM	<unknown>
:	PUN	:
Impossible	ADJ	impossible
de	PRP	de
savoir	VER:infi	savoir
le	DET:ART	le
résultat	NOM	résultat
après	PRP	après
plusieurs	PRO:IND	plusieurs
essais	NOM	essai
DateCommentaire:22	ABR	<unknown>
novembre	NOM	novembre
2014	NUM	@card@
NoteCommentaire:1	ABR	<unknown>
