NomApplication	NOM	<unknown>
:	PUN	:
Véritable	ADJ	véritable
Piano	NAM	<unknown>
Gratuit	NAM	<unknown>
IdApplication	NAM	<unknown>
:	PUN	:
com	NOM	<unknown>
.	SENT	.
gismart	NOM	<unknown>
.	SENT	.
realpianofree	NOM	<unknown>
CategorieApplication	NAM	<unknown>
:	PUN	:
Musique	NOM	musique
et	KON	et
audio	NOM	<unknown>
NoteApplication:4,1	ABR	<unknown>
NombreVotants:13	ABR	<unknown>
287	NUM	@card@
TitreCommentaire	NOM	<unknown>
:	PUN	:
Commentaire	NOM	commentaire
:	PUN	:
c	VER:simp	<unknown>
tros	NOM	<unknown>
net	ADV	net
DateCommentaire:30	ADJ	<unknown>
juillet	NOM	juillet
2014	NUM	@card@
NoteCommentaire:5	ABR	<unknown>
