NomApplication	NAM	<unknown>
:	PUN	:
Voyages-sncf	NAM	<unknown>
IdApplication	NAM	<unknown>
:	PUN	:
com	NOM	<unknown>
.	SENT	.
vsct	NOM	<unknown>
.	SENT	.
vsc	NOM	<unknown>
.	SENT	.
mobile	ADJ	mobile
.	SENT	.
horaireetresa	NOM	<unknown>
.	SENT	.
android	NOM	<unknown>
CategorieApplication	NAM	<unknown>
:	PUN	:
Transports	NOM	transport
NoteApplication:4,2	NAM	<unknown>
NombreVotants:38	ABR	<unknown>
466	NUM	@card@
TitreCommentaire	NOM	<unknown>
:	PUN	:
Application	NOM	application
très	ADV	très
pratique	ADJ	pratique
Commentaire	NAM	<unknown>
:	PUN	:
En	PRP	en
Quelques	NAM	<unknown>
secondes	NUM	second
billet	NOM	billet
réservé	VER:pper	réserver
...	PUN	...
Pas	NOM	pas
d'	PRP	de
erreur	NOM	erreur
et	KON	et
pas	ADV	pas
de	PRP	de
souci	NOM	souci
technique	ADJ	technique
DateCommentaire:5	ADJ	<unknown>
novembre	NOM	novembre
2014	NUM	@card@
NoteCommentaire:5	ABR	<unknown>
