NomApplication	NAM	<unknown>
:	PUN	:
Canalplay	NAM	<unknown>
IdApplication	NAM	<unknown>
:	PUN	:
com	NOM	<unknown>
.	SENT	.
canalplus	NOM	<unknown>
.	SENT	.
canalplay	NOM	<unknown>
.	SENT	.
prod	NOM	<unknown>
CategorieApplication	NAM	<unknown>
:	PUN	:
Divertissement	NOM	divertissement
NoteApplication:4,0	NAM	<unknown>
NombreVotants:6	ABR	<unknown>
901	NUM	@card@
TitreCommentaire	NOM	<unknown>
:	PUN	:
Il	PRO:PER	il
faut	VER:pres	falloir
juste	ADJ	juste
un	DET:ART	un
compte	NOM	compte
canal	NOM	canal
Commentaire	ADJ	<unknown>
:	PUN	:
Avec	PRP	avec
cette	PRO:DEM	ce
appli	NOM	<unknown>
vous	PRO:PER	vous
pouvez	VER:pres	pouvoir
voir	VER:infi	voir
toutes	PRO:IND	tout
les	DET:ART	le
série	NOM	série
avant	PRP	avant
qu'	PRO:REL	que
elle	PRO:PER	elle
soit	VER:subp	être
diffusé	VER:pper	diffuser
à	PRP	à
la	DET:ART	le
télé	NOM	télé
et	KON	et
d'	PRP	de
autres	ADJ	autre
déjà	ADV	déjà
passé	VER:pper	passer
que	KON	que
vous	PRO:PER	vous
voulez	VER:pres	vouloir
revoir	VER:infi	revoir
mais	KON	mais
des	PRP:det	du
fois	NOM	foi|fois
elle	PRO:PER	elle
part	VER:pres	partir
quand	KON	quand
elles	PRO:PER	elle
ne	ADV	ne
sont	VER:pres	être
plus	ADV	plus
diffusés	VER:pper	diffuser
à	PRP	à
la	DET:ART	le
télé	NOM	télé
mais	KON	mais
je	PRO:PER	je
vous	PRO:PER	vous
conseille	VER:pres	conseiller
vraiment	ADV	vraiment
cette	PRO:DEM	ce
application	NOM	application
malgré	PRP	malgré
les	DET:ART	le
petits	ADJ	petit
bugs	NOM	<unknown>
interrompre	VER:infi	interrompre
nous	PRO:PER	nous
films	NOM	film
et	KON	et
séries	NOM	série
DateCommentaire:8	ABR	<unknown>
novembre	NOM	novembre
2014	NUM	@card@
NoteCommentaire:5	ABR	<unknown>
