NomApplication	NAM	<unknown>
:	PUN	:
Infos	NOM	<unknown>
Bus	NAM	<unknown>
,	PUN	,
Métro&Train	NAM	<unknown>
:	PUN	:
Moovit	NAM	<unknown>
IdApplication	NAM	<unknown>
:	PUN	:
com	NOM	<unknown>
.	SENT	.
tranzmate	NOM	<unknown>
CategorieApplication	NAM	<unknown>
:	PUN	:
Transports	NOM	transport
NoteApplication:4,2	NAM	<unknown>
NombreVotants:149	ABR	<unknown>
642	NUM	@card@
TitreCommentaire	NOM	<unknown>
:	PUN	:
Facile	ADJ	facile
à	PRP	à
utiliser	VER:infi	utiliser
Commentaire	NAM	<unknown>
:	PUN	:
Dommage	NOM	dommage
qu'	KON	que
à	PRP	à
orly	NOM	<unknown>
ouest	ADJ	ouest
il	PRO:PER	il
ne	ADV	ne
propose	VER:pres	proposer
pas	ADV	pas
toujours	ADV	toujours
le	DET:ART	le
val	NOM	val
qui	PRO:REL	qui
pourtant	ADV	pourtant
est	VER:pres	être
plus	ADV	plus
rapide	ADJ	rapide
DateCommentaire:18	NOM	<unknown>
novembre	NOM	novembre
2014	NUM	@card@
NoteCommentaire:4	ABR	<unknown>
