NomApplication	NAM	<unknown>
:	PUN	:
Emoji	NAM	<unknown>
Smart	NAM	<unknown>
Android	NAM	<unknown>
Keyboard	NAM	<unknown>
IdApplication	NAM	<unknown>
:	PUN	:
com	NOM	<unknown>
.	SENT	.
emoji	NOM	<unknown>
.	SENT	.
Smart	ADJ	smart
.	SENT	.
Keyboard	NAM	<unknown>
CategorieApplication	NAM	<unknown>
:	PUN	:
Social	ADJ	social
NoteApplication:3,6	NAM	<unknown>
NombreVotants:43	ABR	<unknown>
618	NUM	@card@
TitreCommentaire	NOM	<unknown>
:	PUN	:
Bien	ADV	bien
mais	KON	mais
...	PUN	...
Commentaire	NAM	<unknown>
:	PUN	:
Les	DET:ART	le
Smileys	NAM	<unknown>
et	KON	et
symboles	NOM	symbole
sont	VER:pres	être
variés	VER:pper	varier
mais	KON	mais
cette	PRO:DEM	ce
app	NOM	<unknown>
ne	ADV	ne
marche	VER:pres	marcher
pas	ADV	pas
sur	PRP	sur
le	DET:ART	le
LG	NAM	<unknown>
E-400	ABR	<unknown>
.	SENT	.
Par	PRP	par
contre	NOM	contre
,	PUN	,
elle	PRO:PER	elle
marche	VER:pres	marcher
sur	PRP	sur
la	DET:ART	le
Samsung	ADJ	<unknown>
galaxy	NOM	<unknown>
tab	NOM	tab
3	NUM	@card@
:	PUN	:
)	PUN	)
DateCommentaire:27	ABR	<unknown>
octobre	NOM	octobre
2014	NUM	@card@
NoteCommentaire:3	ABR	<unknown>
