NomApplication	NAM	<unknown>
:	PUN	:
Deezer	NAM	<unknown>
Music	NAM	<unknown>
IdApplication	NAM	<unknown>
:	PUN	:
deezer	NOM	<unknown>
.	SENT	.
android	NOM	<unknown>
.	SENT	.
app	NOM	<unknown>
CategorieApplication	NAM	<unknown>
:	PUN	:
Musique	NOM	musique
et	KON	et
audio	NOM	<unknown>
NoteApplication:4,0	ABR	<unknown>
NombreVotants:371	ABR	<unknown>
730	NUM	@card@
TitreCommentaire	NOM	<unknown>
:	PUN	:
Ergonomie	NOM	ergonomie
à	PRP	à
revoir	VER:infi	revoir
Commentaire	NAM	<unknown>
:	PUN	:
J'	PRO:PER	je
aimerais	VER:cond	aimer
bien	ADV	bien
classer	VER:infi	classer
les	DET:ART	le
artistes	NOM	artiste
de	PRP	de
mes	DET:POS	mon
playlists	NOM	<unknown>
par	PRP	par
ordre	NOM	ordre
alphabétique	ADJ	alphabétique
.	SENT	.
Merci	NOM	merci
également	ADV	également
de	PRP	de
rajouter	VER:infi	rajouter
une	DET:ART	un
fonction	NOM	fonction
pour	PRP	pour
sélectionner	VER:infi	sélectionner
tous	PRO:IND	tout
les	DET:ART	le
albums	NOM	album
et	KON	et
playlists	NOM	<unknown>
en	PRP	en
une	DET:ART	un
seule	ADJ	seul
fois	NOM	foi|fois
plutôt	ADV	plutôt
que	KON	que
de	PRP	de
cliquer	VER:infi	cliquer
sur	PRP	sur
chacune	PRO:IND	chacun
une	NOM	un
à	PRP	à
une	NUM	un
,	PUN	,
lors	ADV	lors
de	PRP	de
la	DET:ART	le
synchro	NOM	synchro
sur	PRP	sur
smartphone	NOM	<unknown>
.	SENT	.
Problème	NOM	problème
de	PRP	de
synchro	NOM	synchro
régulier	ADJ	régulier
:	PUN	:
arrêt	NOM	arrêt
de	PRP	de
lecture	NOM	lecture
après	PRP	après
certains	PRO:IND	certain
titres	NOM	titre
.	SENT	.
DateCommentaire:18	ABR	<unknown>
novembre	NOM	novembre
2014	NUM	@card@
NoteCommentaire:1	ABR	<unknown>
