NomApplication	NAM	<unknown>
:	PUN	:
Le	DET:ART	le
Foot	NAM	<unknown>
Amateur	ADJ	<unknown>
IdApplication	NOM	<unknown>
:	PUN	:
fr	NOM	<unknown>
.	SENT	.
ffflfa	NOM	<unknown>
CategorieApplication	NAM	<unknown>
:	PUN	:
Sports	NOM	sport
NoteApplication:3,6	NAM	<unknown>
NombreVotants:934	NAM	<unknown>
TitreCommentaire	NAM	<unknown>
:	PUN	:
Nul	ADJ	nul
Commentaire	NAM	<unknown>
:	PUN	:
Fait	NOM	fait
que	KON	que
de	PRP	de
planter	VER:infi	planter
.	SENT	.
Calendrier	NOM	calendrier
pas	ADV	pas
complet	ADJ	complet
alors	ADV	alors
qu'	KON	que
il	PRO:PER	il
reste	VER:pres	rester
que	KON	que
2	NUM	@card@
journées	NOM	journée
...	PUN	...
DateCommentaire:4	ABR	<unknown>
mai	NOM	mai
2014	NUM	@card@
NoteCommentaire:1	ABR	<unknown>
