NomApplication	NAM	<unknown>
:	PUN	:
Leboncoin	NAM	<unknown>
IdApplication	NAM	<unknown>
:	PUN	:
fr	NOM	<unknown>
.	SENT	.
leboncoin	NOM	<unknown>
CategorieApplication	NAM	<unknown>
:	PUN	:
Shopping	NOM	shopping
NoteApplication:4,1	NAM	<unknown>
NombreVotants:45	ABR	<unknown>
209	NUM	@card@
TitreCommentaire	NOM	<unknown>
:	PUN	:
Pas	ADV	pas
beaucoup	ADV	beaucoup
d'	PRP	de
évolution	NOM	évolution
Commentaire	ADJ	<unknown>
:	PUN	:
Des	PRP:det	du
filtres	NOM	filtre
de	PRP	de
recherche	NOM	recherche
plus	ADV	plus
poussées	NOM	poussée
serais	VER:cond	être
pas	ADV	pas
du	PRP:det	du
luxe	NOM	luxe
...	PUN	...
genre	NOM	genre
type	NOM	type
de	PRP	de
vehicule	NOM	<unknown>
:	PUN	:
monospace	NOM	<unknown>
,	PUN	,
suv	NOM	<unknown>
...	PUN	...
selectionner	VER:infi	<unknown>
nous	PRO:PER	nous
même	ADV	même
les	DET:ART	le
departements	NOM	<unknown>
de	PRP	de
recherche	NOM	recherche
serais	VER:cond	être
un	DET:ART	un
plus	ADV	plus
...	PUN	...
merci	NOM	merci
d'	PRP	de
y	PRO:PER	y
penser	VER:infi	penser
leboncoin	NOM	<unknown>
DateCommentaire:28	ABR	<unknown>
octobre	NOM	octobre
2014	NUM	@card@
NoteCommentaire:3	ABR	<unknown>
