NomApplication	NAM	<unknown>
:	PUN	:
Leboncoin	NAM	<unknown>
IdApplication	NAM	<unknown>
:	PUN	:
fr	NOM	<unknown>
.	SENT	.
leboncoin	NOM	<unknown>
CategorieApplication	NAM	<unknown>
:	PUN	:
Shopping	NOM	shopping
NoteApplication:4,1	NAM	<unknown>
NombreVotants:45	ABR	<unknown>
209	NUM	@card@
TitreCommentaire	NOM	<unknown>
:	PUN	:
Rien	NOM	rien
à	PRP	à
dire	VER:infi	dire
!	SENT	!
Commentaire	NOM	commentaire
:	PUN	:
Excellente	ADJ	excellent
app	NOM	<unknown>
surtout	ADV	surtout
depuis	PRP	depuis
les	DET:ART	le
mises	NOM	mise
à	PRP	à
jour	NOM	jour
.	SENT	.
J'	PRO:PER	je
espère	VER:pres	espérer
une	DET:ART	un
évolution	NOM	évolution
:	PUN	:
pourquoi	ADV	pourquoi
pas	ADV	pas
un	DET:ART	un
tchat	NOM	<unknown>
intégrer	VER:infi	intégrer
,	PUN	,
plusieurs	PRO:IND	plusieurs
filtres	NOM	filtre
pour	PRP	pour
affiner	VER:infi	affiner
ses	DET:POS	son
recherches	NOM	recherche
et	KON	et
une	DET:ART	un
évaluation	NOM	évaluation
des	PRP:det	du
vendeurs/acheteurs	NOM	<unknown>
DateCommentaire:29	ABR	<unknown>
octobre	NOM	octobre
2014	NUM	@card@
NoteCommentaire:5	ABR	<unknown>
