NomApplication	NAM	<unknown>
:	PUN	:
Météo-France	NAM	<unknown>
IdApplication	NAM	<unknown>
:	PUN	:
fr	NOM	<unknown>
.	SENT	.
meteo	NOM	<unknown>
CategorieApplication	NAM	<unknown>
:	PUN	:
Météo	NOM	météo
NoteApplication:3,3	NAM	<unknown>
NombreVotants:12	ABR	<unknown>
126	NUM	@card@
TitreCommentaire	NOM	<unknown>
:	PUN	:
Bonne	ADJ	bon
previ	NOM	<unknown>
Commentaire	ADJ	<unknown>
:	PUN	:
les	DET:ART	le
previ	NOM	<unknown>
sont	VER:pres	être
bien	ADV	bien
meilleures	ADJ	meilleur
que	KON	que
chez	PRP	chez
les	DET:ART	le
concurrents	NOM	concurrent
,	PUN	,
mais	KON	mais
améliorer	VER:infi	améliorer
l'	DET:ART	le
ergonomie	NOM	ergonomie
!	SENT	!
DateCommentaire:27	ABR	<unknown>
septembre	NOM	septembre
2014	NUM	@card@
NoteCommentaire:5	ABR	<unknown>
