NomApplication	NAM	<unknown>
:	PUN	:
ZEDGEâ„¢	NAM	<unknown>
Ringtones	VER:pres	<unknown>
&	SYM	&
Wallpapers	NAM	<unknown>
IdApplication	NAM	<unknown>
:	PUN	:
net	ADJ	net
.	SENT	.
zedge	NOM	<unknown>
.	SENT	.
android	NOM	<unknown>
CategorieApplication	NAM	<unknown>
:	PUN	:
Personnalisation	NOM	personnalisation
NoteApplication:4,5	NAM	<unknown>
NombreVotants:2	ABR	<unknown>
028	NUM	@card@
675	NUM	@card@
TitreCommentaire	NOM	<unknown>
:	PUN	:
Commentaire	NOM	commentaire
:	PUN	:
Plein	ADJ	plein
de	PRP	de
sons	NOM	son
pour	PRP	pour
tous	PRO:IND	tout
DateCommentaire:21	NOM	<unknown>
novembre	NOM	novembre
2014	NUM	@card@
NoteCommentaire:5	ABR	<unknown>
