NomApplication	NAM	<unknown>
:	PUN	:
Wikipedia	NAM	<unknown>
Mobile	NAM	<unknown>
IdApplication	NAM	<unknown>
:	PUN	:
org	NOM	<unknown>
.	SENT	.
wikipedia	NOM	<unknown>
CategorieApplication	NAM	<unknown>
:	PUN	:
Livres	NOM	livre
et	KON	et
références	NOM	référence
NoteApplication:4,3	ABR	<unknown>
NombreVotants:237	ABR	<unknown>
783	NUM	@card@
TitreCommentaire	NOM	<unknown>
:	PUN	:
HTC	NOM	<unknown>
one	NOM	<unknown>
s	VER:subi	<unknown>
Commentaire	ADJ	<unknown>
:	PUN	:
Quand	KON	quand
je	PRO:PER	je
rentre	VER:pres	rentrer
une	DET:ART	un
recherche	NOM	recherche
elle	PRO:PER	elle
s'	PRO:PER	se
efface	VER:pres	effacer
automatiquement	ADV	automatiquement
!	SENT	!
Une	DET:ART	un
MAJ	NOM	<unknown>
vite	ADV	vite
DateCommentaire:20	ADJ	<unknown>
novembre	NOM	novembre
2014	NUM	@card@
NoteCommentaire:2	ABR	<unknown>
