NomApplication	NAM	<unknown>
:	PUN	:
Trafic	NOM	trafic
Futé	NAM	<unknown>
IdApplication	NAM	<unknown>
:	PUN	:
org	NOM	<unknown>
.	SENT	.
scoutant	NOM	<unknown>
.	SENT	.
tf	NOM	<unknown>
CategorieApplication	NAM	<unknown>
:	PUN	:
Transports	NOM	transport
NoteApplication:4,0	NAM	<unknown>
NombreVotants:4	ABR	<unknown>
078	NUM	@card@
TitreCommentaire	NOM	<unknown>
:	PUN	:
Bonne	ADJ	bon
appli	NOM	<unknown>
pour	PRP	pour
autoroutes	NOM	autoroute
Commentaire	ADJ	<unknown>
:	PUN	:
Ne	ADV	ne
montre	VER:pres	montrer
pas	ADV	pas
le	DET:ART	le
trafic	NOM	trafic
sur	PRP	sur
les	DET:ART	le
routes	NOM	route
nationales	ADJ	national
.	SENT	.
DateCommentaire:1	ABR	<unknown>
août	NOM	août
2014	NUM	@card@
NoteCommentaire:4	ABR	<unknown>
